|||||||||||||||||||||||||||||||||||||||||||||||||||||
|||||||||||||||||||||||||||||||||||||||||||||||||||||
||.|...|.|...|#####....|...|...|.|...|....######...||
||.|||.|.|.|.|.|||||||.|.|.|.|||.|.|||||||.|||.|.|.||
||.|.....|.|.|.###.|...|.|.###.|.....|.......|.|.|.||
||#|||.|||.|||.|.|||||||||||.|.|.|||||.|||||.|.|||#||
||#......|.....|.|...|.|...|.|.|.....|.|.|.|.|.|..#||
||#|||.|.|.|||.|||||.|.|.|.|||.|||.|||.|.|.|||||.|#||
||.|...|.###.|.|...|...|.|....########...|.###...|.||
||.|.|||.|.|||||||.|||.|.|||.|||.|||||.|||||.|||||.||
||.|.|.|.|...|.........|||||||.........|...|.....|.||
||||.|.|||||.|||.||..||..###..||..||||.|||.|||.|.||||
||.|...|.|.|###|...||...........||.|.......|..#|...||
||.|||.|.|.|||.|.|.##.....A.....##.|.|#|.|||||.||||||
||##.....|...|...|.||...........||...|#|...|...|...||
||.|||||||.|.|||||...||..###..||...|#|.|||.|.|.|.||||
||.....|###|......###..|||||||.....|#|.|...|.|...|.||
||.|||#|.|||.|||||.|.|||||.|||.|||||.|||||||||||.|#||
||.|.|#|.|.....|...|.|.......|.|.....|.####..|.|..#||
||.|.|.|.|||.|||||.|||||.|.|||||||.|.|||.|||||.|.|#||
||.|.|...|...|.....|...|.|.|...|.|.|.|.....|.....|.||
||||#|||.|#|.|||||.|||.|||.|.|.|.|.|.|||||.|||||||.||
||###....|#|.....|.....|..#..|.|.##|.....|.|.|.|...||
||#|||||.|#|||||.|||||.|||.|||.|||.|||||.|.|.|.|||.||
||#..|...|...|.....|.###...|..#|.......|..#####....||
|||||||||||||||||||||||||||||||||||||||||||||||||||||
|||||||||||||||||||||||||||||||||||||||||||||||||||||